autocd         	off
cdable_vars    	on
cdspell        	on
checkhash      	on
checkjobs      	off
checkwinsize   	on
cmdhist        	on
compat31       	on
compat32       	off
compat40       	off
compat41       	off
compat42       	off
compat43       	off
complete_fullquote	on
completion_strip_exe	off
direxpand      	off
dirspell       	off
dotglob        	on
execfail       	on
expand_aliases 	on
extdebug       	on
extglob        	on
extquote       	on
failglob       	on
force_fignore  	on
globasciiranges	off
globstar       	off
gnu_errfmt     	on
histappend     	on
histreedit     	on
histverify     	off
hostcomplete   	on
huponexit      	off
inherit_errexit	off
interactive_comments	on
lastpipe       	off
lithist        	off
login_shell    	off
mailwarn       	off
no_empty_cmd_completion	on
nocaseglob     	on
nocasematch    	on
nullglob       	off
progcomp       	on
promptvars     	on
restricted_shell	off
shift_verbose  	off
sourcepath     	on
xpg_echo       	off
